Afcfp-n	Definite=Ind|Degree=Cmp|Gender=Fem|Number=Plur
Afcfson	Case=Dat,Gen|Definite=Ind|Degree=Cmp|Gender=Fem|Number=Sing
Afcfsrn	Case=Acc,Nom|Definite=Ind|Degree=Cmp|Gender=Fem|Number=Sing
Afcmpoy	Case=Dat,Gen|Definite=Def|Degree=Cmp|Gender=Masc|Number=Plur
Afcms-n	Definite=Ind|Degree=Cmp|Gender=Masc|Number=Sing
Afp	Degree=Pos
Afpf--n	Definite=Ind|Degree=Pos|Gender=Fem
Afpfp-n	Definite=Ind|Degree=Pos|Gender=Fem|Number=Plur
Afpfp-ny	Definite=Ind|Degree=Pos|Gender=Fem|Number=Plur|Variant=Short
Afpfpoy	Case=Dat,Gen|Definite=Def|Degree=Pos|Gender=Fem|Number=Plur
Afpfpry	Case=Acc,Nom|Definite=Def|Degree=Pos|Gender=Fem|Number=Plur
Afpfson	Case=Dat,Gen|Definite=Ind|Degree=Pos|Gender=Fem|Number=Sing
Afpfsoy	Case=Dat,Gen|Definite=Def|Degree=Pos|Gender=Fem|Number=Sing
Afpfsrn	Case=Acc,Nom|Definite=Ind|Degree=Pos|Gender=Fem|Number=Sing
Afpfsry	Case=Acc,Nom|Definite=Def|Degree=Pos|Gender=Fem|Number=Sing
Afpm--n	Definite=Ind|Degree=Pos|Gender=Masc
Afpmp-n	Definite=Ind|Degree=Pos|Gender=Masc|Number=Plur
Afpmpoy	Case=Dat,Gen|Definite=Def|Degree=Pos|Gender=Masc|Number=Plur
Afpmpry	Case=Acc,Nom|Definite=Def|Degree=Pos|Gender=Masc|Number=Plur
Afpms-n	Definite=Ind|Degree=Pos|Gender=Masc|Number=Sing
Afpmsoy	Case=Dat,Gen|Definite=Def|Degree=Pos|Gender=Masc|Number=Sing
Afpmsry	Case=Acc,Nom|Definite=Def|Degree=Pos|Gender=Masc|Number=Sing
Afp-p-n	Definite=Ind|Degree=Pos|Number=Plur
Afp-poy	Case=Dat,Gen|Definite=Def|Degree=Pos|Number=Plur
Afp-s-n	Definite=Ind|Degree=Pos|Number=Sing
Afsfp-n	Definite=Ind|Degree=Sup|Gender=Fem|Number=Plur
Afsfsrn	Case=Acc,Nom|Definite=Ind|Degree=Sup|Gender=Fem|Number=Sing
Ccssp	Polarity=Pos
Ccsspy	Polarity=Pos|Variant=Short
Crssp	Polarity=Pos
Csssp	Polarity=Pos
Cssspy	Polarity=Pos|Variant=Short
Dd3fpo	Case=Dat,Gen|Gender=Fem|Number=Plur|Person=3|PronType=Dem
Dd3fpr	Case=Acc,Nom|Gender=Fem|Number=Plur|Person=3|PronType=Dem
Dd3fpr---e	Case=Acc,Nom|Gender=Fem|Number=Plur|Person=3|Position=Prenom|PronType=Dem
Dd3fpr---o	Case=Acc,Nom|Gender=Fem|Number=Plur|Person=3|Position=Postnom|PronType=Dem
Dd3fpr--y	Case=Acc,Nom|Gender=Fem|Number=Plur|Person=3|PronType=Dem
Dd3fso	Case=Dat,Gen|Gender=Fem|Number=Sing|Person=3|PronType=Dem
Dd3fso---e	Case=Dat,Gen|Gender=Fem|Number=Sing|Person=3|Position=Prenom|PronType=Dem
Dd3fsr	Case=Acc,Nom|Gender=Fem|Number=Sing|Person=3|PronType=Dem
Dd3fsr---e	Case=Acc,Nom|Gender=Fem|Number=Sing|Person=3|Position=Prenom|PronType=Dem
Dd3fsr---o	Case=Acc,Nom|Gender=Fem|Number=Sing|Person=3|Position=Postnom|PronType=Dem
Dd3fsr--yo	Case=Acc,Nom|Gender=Fem|Number=Sing|Person=3|Position=Postnom|PronType=Dem
Dd3mpo	Case=Dat,Gen|Gender=Masc|Number=Plur|Person=3|PronType=Dem
Dd3mpr	Case=Acc,Nom|Gender=Masc|Number=Plur|Person=3|PronType=Dem
Dd3mpr---e	Case=Acc,Nom|Gender=Masc|Number=Plur|Person=3|Position=Prenom|PronType=Dem
Dd3mpr---o	Case=Acc,Nom|Gender=Masc|Number=Plur|Person=3|Position=Postnom|PronType=Dem
Dd3mso---e	Case=Dat,Gen|Gender=Masc|Number=Sing|Person=3|Position=Prenom|PronType=Dem
Dd3msr	Case=Acc,Nom|Gender=Masc|Number=Sing|Person=3|PronType=Dem
Dd3msr---e	Case=Acc,Nom|Gender=Masc|Number=Sing|Person=3|Position=Prenom|PronType=Dem
Dd3msr---o	Case=Acc,Nom|Gender=Masc|Number=Sing|Person=3|Position=Postnom|PronType=Dem
Dd3-po---e	Case=Dat,Gen|Number=Plur|Person=3|Position=Prenom|PronType=Dem
Dd3-po---o	Case=Dat,Gen|Number=Plur|Person=3|Position=Postnom|PronType=Dem
Dh1ms	Gender=Masc|Number=Sing|Person=1|PronType=Emp
Dh3fp	Gender=Fem|Number=Plur|Person=3|PronType=Emp
Dh3fso	Case=Dat,Gen|Gender=Fem|Number=Sing|Person=3|PronType=Emp
Dh3fsr	Case=Acc,Nom|Gender=Fem|Number=Sing|Person=3|PronType=Emp
Dh3mp	Gender=Masc|Number=Plur|Person=3|PronType=Emp
Dh3ms	Gender=Masc|Number=Sing|Person=3|PronType=Emp
Di3	Person=3|PronType=Ind
Di3fp	Gender=Fem|Number=Plur|Person=3|PronType=Ind
Di3fpr	Case=Acc,Nom|Gender=Fem|Number=Plur|Person=3|PronType=Ind
Di3fpr---e	Case=Acc,Nom|Gender=Fem|Number=Plur|Person=3|Position=Prenom|PronType=Ind
Di3fso	Case=Dat,Gen|Gender=Fem|Number=Sing|Person=3|PronType=Ind
Di3fso---e	Case=Dat,Gen|Gender=Fem|Number=Sing|Person=3|Position=Prenom|PronType=Ind
Di3fsr	Case=Acc,Nom|Gender=Fem|Number=Sing|Person=3|PronType=Ind
Di3fsr---e	Case=Acc,Nom|Gender=Fem|Number=Sing|Person=3|Position=Prenom|PronType=Ind
Di3mp	Gender=Masc|Number=Plur|Person=3|PronType=Ind
Di3mpr	Case=Acc,Nom|Gender=Masc|Number=Plur|Person=3|PronType=Ind
Di3mpr---e	Case=Acc,Nom|Gender=Masc|Number=Plur|Person=3|Position=Prenom|PronType=Ind
Di3ms	Gender=Masc|Number=Sing|Person=3|PronType=Ind
Di3ms----e	Gender=Masc|Number=Sing|Person=3|Position=Prenom|PronType=Ind
Di3mso---e	Case=Dat,Gen|Gender=Masc|Number=Sing|Person=3|Position=Prenom|PronType=Ind
Di3msr	Case=Acc,Nom|Gender=Masc|Number=Sing|Person=3|PronType=Ind
Di3msr---e	Case=Acc,Nom|Gender=Masc|Number=Sing|Person=3|Position=Prenom|PronType=Ind
Di3-po	Case=Dat,Gen|Number=Plur|Person=3|PronType=Ind
Di3-po---e	Case=Dat,Gen|Number=Plur|Person=3|Position=Prenom|PronType=Ind
Di3--r---e	Case=Acc,Nom|Person=3|Position=Prenom|PronType=Ind
Di3-sr	Case=Acc,Nom|Number=Sing|Person=3|PronType=Ind
Di3-sr---e	Case=Acc,Nom|Number=Sing|Person=3|Position=Prenom|PronType=Ind
Di3-sr--y	Case=Acc,Nom|Number=Sing|Person=3|PronType=Ind
Di3-----y	Person=3|PronType=Ind
Ds1fp-p	Gender=Fem|Number=Plur|Number[psor]=Plur|Person=1|Poss=Yes|PronType=Prs
Ds1fp-s	Gender=Fem|Number=Plur|Number[psor]=Sing|Person=1|Poss=Yes|PronType=Prs
Ds1fsop	Case=Dat,Gen|Gender=Fem|Number=Sing|Number[psor]=Plur|Person=1|Poss=Yes|PronType=Prs
Ds1fsos	Case=Dat,Gen|Gender=Fem|Number=Sing|Number[psor]=Sing|Person=1|Poss=Yes|PronType=Prs
Ds1fsrp	Case=Acc,Nom|Gender=Fem|Number=Sing|Number[psor]=Plur|Person=1|Poss=Yes|PronType=Prs
Ds1fsrs	Case=Acc,Nom|Gender=Fem|Number=Sing|Number[psor]=Sing|Person=1|Poss=Yes|PronType=Prs
Ds1fsrs-y	Case=Acc,Nom|Gender=Fem|Number=Sing|Number[psor]=Sing|Person=1|Poss=Yes|PronType=Prs
Ds1mp-p	Gender=Masc|Number=Plur|Number[psor]=Plur|Person=1|Poss=Yes|PronType=Prs
Ds1mp-s	Gender=Masc|Number=Plur|Number[psor]=Sing|Person=1|Poss=Yes|PronType=Prs
Ds1ms-p	Gender=Masc|Number=Sing|Number[psor]=Plur|Person=1|Poss=Yes|PronType=Prs
Ds1msrs-y	Case=Acc,Nom|Gender=Masc|Number=Sing|Number[psor]=Sing|Person=1|Poss=Yes|PronType=Prs
Ds1ms-s	Gender=Masc|Number=Sing|Number[psor]=Sing|Person=1|Poss=Yes|PronType=Prs
Ds2fp-p	Gender=Fem|Number=Plur|Number[psor]=Plur|Person=2|Poss=Yes|PronType=Prs
Ds2fp-s	Gender=Fem|Number=Plur|Number[psor]=Sing|Person=2|Poss=Yes|PronType=Prs
Ds2fsrp	Case=Acc,Nom|Gender=Fem|Number=Sing|Number[psor]=Plur|Person=2|Poss=Yes|PronType=Prs
Ds2fsrs	Case=Acc,Nom|Gender=Fem|Number=Sing|Number[psor]=Sing|Person=2|Poss=Yes|PronType=Prs
Ds2mp-p	Gender=Masc|Number=Plur|Number[psor]=Plur|Person=2|Poss=Yes|PronType=Prs
Ds2mp-s	Gender=Masc|Number=Plur|Number[psor]=Sing|Person=2|Poss=Yes|PronType=Prs
Ds2ms-p	Gender=Masc|Number=Sing|Number[psor]=Plur|Person=2|Poss=Yes|PronType=Prs
Ds2ms-s	Gender=Masc|Number=Sing|Number[psor]=Sing|Person=2|Poss=Yes|PronType=Prs
Ds2---s	Number[psor]=Sing|Person=2|Poss=Yes|PronType=Prs
Ds3fp-s	Gender=Fem|Number=Plur|Number[psor]=Sing|Person=3|Poss=Yes|PronType=Prs
Ds3fsos	Case=Dat,Gen|Gender=Fem|Number=Sing|Number[psor]=Sing|Person=3|Poss=Yes|PronType=Prs
Ds3fsrs	Case=Acc,Nom|Gender=Fem|Number=Sing|Number[psor]=Sing|Person=3|Poss=Yes|PronType=Prs
Ds3mp-s	Gender=Masc|Number=Plur|Number[psor]=Sing|Person=3|Poss=Yes|PronType=Prs
Ds3ms-s	Gender=Masc|Number=Sing|Number[psor]=Sing|Person=3|Poss=Yes|PronType=Prs
Ds3---p	Number[psor]=Plur|Person=3|Poss=Yes|PronType=Prs
Ds3---s	Number[psor]=Sing|Person=3|Poss=Yes|PronType=Prs
Ds3---sy	Number[psor]=Sing|Person=3|Poss=Yes|PronType=Prs
Dw3fpr	Case=Acc,Nom|Gender=Fem|Number=Plur|Person=3|PronType=Int,Rel
Dw3fso---e	Case=Dat,Gen|Gender=Fem|Number=Sing|Person=3|Position=Prenom|PronType=Int,Rel
Dw3fsr	Case=Acc,Nom|Gender=Fem|Number=Sing|Person=3|PronType=Int,Rel
Dw3mpr	Case=Acc,Nom|Gender=Masc|Number=Plur|Person=3|PronType=Int,Rel
Dw3mso---e	Case=Dat,Gen|Gender=Masc|Number=Sing|Person=3|Position=Prenom|PronType=Int,Rel
Dw3msr	Case=Acc,Nom|Gender=Masc|Number=Sing|Person=3|PronType=Int,Rel
Dw3-po---e	Case=Dat,Gen|Number=Plur|Person=3|Position=Prenom|PronType=Int,Rel
Dw3--r---e	Case=Acc,Nom|Person=3|Position=Prenom|PronType=Int,Rel
Dz3fsr---e	Case=Acc,Nom|Gender=Fem|Number=Sing|Person=3|Position=Prenom|PronType=Neg
Dz3mso---e	Case=Dat,Gen|Gender=Masc|Number=Sing|Person=3|Position=Prenom|PronType=Neg
Dz3msr---e	Case=Acc,Nom|Gender=Masc|Number=Sing|Person=3|Position=Prenom|PronType=Neg
M	NumType=Card
Mcfp-l	Gender=Fem|Number=Plur|NumForm=Word|NumType=Card
Mcfp-ln	Definite=Ind|Gender=Fem|Number=Plur|NumForm=Word|NumType=Card
Mcfprln	Case=Acc,Nom|Definite=Ind|Gender=Fem|Number=Plur|NumForm=Word|NumType=Card
Mcfprly	Case=Acc,Nom|Definite=Def|Gender=Fem|Number=Plur|NumForm=Word|NumType=Card
Mcfsoln	Case=Dat,Gen|Definite=Ind|Gender=Fem|Number=Sing|NumForm=Word|NumType=Card
Mcfsrl	Case=Acc,Nom|Gender=Fem|Number=Sing|NumForm=Word|NumType=Card
Mcfsrln	Case=Acc,Nom|Definite=Ind|Gender=Fem|Number=Sing|NumForm=Word|NumType=Card
Mcfsrly	Case=Acc,Nom|Definite=Def|Gender=Fem|Number=Sing|NumForm=Word|NumType=Card
Mcmp-l	Gender=Masc|Number=Plur|NumForm=Word|NumType=Card
Mcms-ln	Definite=Ind|Gender=Masc|Number=Sing|NumForm=Word|NumType=Card
Mcmsrl	Case=Acc,Nom|Gender=Masc|Number=Sing|NumForm=Word|NumType=Card
Mcmsrln	Case=Acc,Nom|Definite=Ind|Gender=Masc|Number=Sing|NumForm=Word|NumType=Card
Mcmsrly	Case=Acc,Nom|Definite=Def|Gender=Masc|Number=Sing|NumForm=Word|NumType=Card
Mc-p-d	Number=Plur|NumForm=Digit|NumType=Card
Mc-p-l	Number=Plur|NumForm=Word|NumType=Card
Mc-s-b	Number=Sing|NumForm=Combi|NumType=Card
Mc-s-d	Number=Sing|NumForm=Digit|NumType=Card
Mffprln	Case=Acc,Nom|Definite=Ind|Gender=Fem|Number=Plur|NumForm=Word|NumType=Card
Mffsrln	Case=Acc,Nom|Definite=Ind|Gender=Fem|Number=Sing|NumForm=Word|NumType=Card
Mlfpo	Case=Dat,Gen|Gender=Fem|Number=Plur|NumType=Card|PronType=Tot
Mlfpr	Case=Acc,Nom|Gender=Fem|Number=Plur|NumType=Card|PronType=Tot
Mlmpr	Case=Acc,Nom|Gender=Masc|Number=Plur|NumType=Card|PronType=Tot
Mofp-ln	Definite=Ind|Gender=Fem|Number=Plur|NumForm=Word|NumType=Ord
Mofpoly	Case=Dat,Gen|Definite=Def|Gender=Fem|Number=Plur|NumForm=Word|NumType=Ord
Mofprly	Case=Acc,Nom|Definite=Def|Gender=Fem|Number=Plur|NumForm=Word|NumType=Ord
Mofs-l	Gender=Fem|Number=Sing|NumForm=Word|NumType=Ord
Mofsoln	Case=Dat,Gen|Definite=Ind|Gender=Fem|Number=Sing|NumForm=Word|NumType=Ord
Mofsoly	Case=Dat,Gen|Definite=Def|Gender=Fem|Number=Sing|NumForm=Word|NumType=Ord
Mofsrln	Case=Acc,Nom|Definite=Ind|Gender=Fem|Number=Sing|NumForm=Word|NumType=Ord
Mofsrly	Case=Acc,Nom|Definite=Def|Gender=Fem|Number=Sing|NumForm=Word|NumType=Ord
Mo---l	NumForm=Word|NumType=Ord
Mo---ln	Definite=Ind|NumForm=Word|NumType=Ord
Mompoly	Case=Dat,Gen|Definite=Def|Gender=Masc|Number=Plur|NumForm=Word|NumType=Ord
Momprly	Case=Acc,Nom|Definite=Def|Gender=Masc|Number=Plur|NumForm=Word|NumType=Ord
Moms-l	Gender=Masc|Number=Sing|NumForm=Word|NumType=Ord
Moms-ln	Definite=Ind|Gender=Masc|Number=Sing|NumForm=Word|NumType=Ord
Momsoly	Case=Dat,Gen|Definite=Def|Gender=Masc|Number=Sing|NumForm=Word|NumType=Ord
Momsrly	Case=Acc,Nom|Definite=Def|Gender=Masc|Number=Sing|NumForm=Word|NumType=Ord
Mo-s-r	Number=Sing|NumForm=Roman|NumType=Ord
Ncf--n	Definite=Ind|Gender=Fem
Ncfp-n	Definite=Ind|Gender=Fem|Number=Plur
Ncfpoy	Case=Dat,Gen|Definite=Def|Gender=Fem|Number=Plur
Ncfpry	Case=Acc,Nom|Definite=Def|Gender=Fem|Number=Plur
Ncfs-n	Definite=Ind|Gender=Fem|Number=Sing
Ncfson	Case=Dat,Gen|Definite=Ind|Gender=Fem|Number=Sing
Ncfsoy	Case=Dat,Gen|Definite=Def|Gender=Fem|Number=Sing
Ncfsrn	Case=Acc,Nom|Definite=Ind|Gender=Fem|Number=Sing
Ncfsry	Case=Acc,Nom|Definite=Def|Gender=Fem|Number=Sing
Ncfsryy	Case=Acc,Nom|Definite=Def|Gender=Fem|Number=Sing|Variant=Short
Ncfsvy	Case=Voc|Definite=Def|Gender=Fem|Number=Sing
Ncm--n	Definite=Ind|Gender=Masc
Ncmp-n	Definite=Ind|Gender=Masc|Number=Plur
Ncmpoy	Case=Dat,Gen|Definite=Def|Gender=Masc|Number=Plur
Ncmpry	Case=Acc,Nom|Definite=Def|Gender=Masc|Number=Plur
Ncms-n	Definite=Ind|Gender=Masc|Number=Sing
Ncms-ny	Definite=Ind|Gender=Masc|Number=Sing|Variant=Short
Ncmsoy	Case=Dat,Gen|Definite=Def|Gender=Masc|Number=Sing
Ncmsrn	Case=Acc,Nom|Definite=Ind|Gender=Masc|Number=Sing
Ncmsry	Case=Acc,Nom|Definite=Def|Gender=Masc|Number=Sing
Ncmsryy	Case=Acc,Nom|Definite=Def|Gender=Masc|Number=Sing|Variant=Short
Ncmsvn	Case=Voc|Definite=Ind|Gender=Masc|Number=Sing
Ncmsvy	Case=Voc|Definite=Def|Gender=Masc|Number=Sing
Ncms-y	Definite=Def|Gender=Masc|Number=Sing
Nc---n	Definite=Ind
Npfson	Case=Dat,Gen|Definite=Ind|Gender=Fem|Number=Sing
Npfsoy	Case=Dat,Gen|Definite=Def|Gender=Fem|Number=Sing
Npfsrn	Case=Acc,Nom|Definite=Ind|Gender=Fem|Number=Sing
Npfsry	Case=Acc,Nom|Definite=Def|Gender=Fem|Number=Sing
Npmpoy	Case=Dat,Gen|Definite=Def|Gender=Masc|Number=Plur
Npmpry	Case=Acc,Nom|Definite=Def|Gender=Masc|Number=Plur
Npms-n	Definite=Ind|Gender=Masc|Number=Sing
Npmsoy	Case=Dat,Gen|Definite=Def|Gender=Masc|Number=Sing
Npmsry	Case=Acc,Nom|Definite=Def|Gender=Masc|Number=Sing
Pd3fpr	Case=Acc,Nom|Gender=Fem|Number=Plur|Person=3|PronType=Dem
Pd3fso	Case=Dat,Gen|Gender=Fem|Number=Sing|Person=3|PronType=Dem
Pd3fsr	Case=Acc,Nom|Gender=Fem|Number=Sing|Person=3|PronType=Dem
Pd3mpo	Case=Dat,Gen|Gender=Masc|Number=Plur|Person=3|PronType=Dem
Pd3mpr	Case=Acc,Nom|Gender=Masc|Number=Plur|Person=3|PronType=Dem
Pd3mpr--y	Case=Acc,Nom|Gender=Masc|Number=Plur|Person=3|PronType=Dem|Variant=Short
Pd3mso	Case=Dat,Gen|Gender=Masc|Number=Sing|Person=3|PronType=Dem
Pd3msr	Case=Acc,Nom|Gender=Masc|Number=Sing|Person=3|PronType=Dem
Pd3-po	Case=Dat,Gen|Number=Plur|Person=3|PronType=Dem
Pi3fpr	Case=Acc,Nom|Gender=Fem|Number=Plur|Person=3|PronType=Ind
Pi3fso	Case=Dat,Gen|Gender=Fem|Number=Sing|Person=3|PronType=Ind
Pi3fsr	Case=Acc,Nom|Gender=Fem|Number=Sing|Person=3|PronType=Ind
Pi3mpr	Case=Acc,Nom|Gender=Masc|Number=Plur|Person=3|PronType=Ind
Pi3mso	Case=Dat,Gen|Gender=Masc|Number=Sing|Person=3|PronType=Ind
Pi3msr	Case=Acc,Nom|Gender=Masc|Number=Sing|Person=3|PronType=Ind
Pi3msr--y	Case=Acc,Nom|Gender=Masc|Number=Sing|Person=3|PronType=Ind|Variant=Short
Pi3-po	Case=Dat,Gen|Number=Plur|Person=3|PronType=Ind
Pi3--r	Case=Acc,Nom|Person=3|PronType=Ind
Pi3-so	Case=Dat,Gen|Number=Sing|Person=3|PronType=Ind
Pi3-sr	Case=Acc,Nom|Number=Sing|Person=3|PronType=Ind
Pp1-pa--------w	Case=Acc|Number=Plur|Person=1|PronType=Prs|Strength=Weak
Pp1-pa--y-----w	Case=Acc|Number=Plur|Person=1|PronType=Prs|Strength=Weak|Variant=Short
Pp1-pd--------s	Case=Dat|Number=Plur|Person=1|PronType=Prs|Strength=Strong
Pp1-pd--------w	Case=Dat|Number=Plur|Person=1|PronType=Prs|Strength=Weak
Pp1-pd--y-----w	Case=Dat|Number=Plur|Person=1|PronType=Prs|Strength=Weak|Variant=Short
Pp1-pr--------s	Case=Acc,Nom|Number=Plur|Person=1|PronType=Prs|Strength=Strong
Pp1-sa--------s	Case=Acc|Number=Sing|Person=1|PronType=Prs|Strength=Strong
Pp1-sa--------w	Case=Acc|Number=Sing|Person=1|PronType=Prs|Strength=Weak
Pp1-sa--y-----w	Case=Acc|Number=Sing|Person=1|PronType=Prs|Strength=Weak|Variant=Short
Pp1-sd--------s	Case=Dat|Number=Sing|Person=1|PronType=Prs|Strength=Strong
Pp1-sd--------w	Case=Dat|Number=Sing|Person=1|PronType=Prs|Strength=Weak
Pp1-sd--y-----w	Case=Dat|Number=Sing|Person=1|PronType=Prs|Strength=Weak|Variant=Short
Pp1-sn--------s	Case=Nom|Number=Sing|Person=1|PronType=Prs|Strength=Strong
Pp2-pa--------w	Case=Acc|Number=Plur|Person=2|PronType=Prs|Strength=Weak
Pp2-pa--y-----w	Case=Acc|Number=Plur|Person=2|PronType=Prs|Strength=Weak|Variant=Short
Pp2-pd--------w	Case=Dat|Number=Plur|Person=2|PronType=Prs|Strength=Weak
Pp2-pd--y-----w	Case=Dat|Number=Plur|Person=2|PronType=Prs|Strength=Weak|Variant=Short
Pp2-pr--------s	Case=Acc,Nom|Number=Plur|Person=2|PronType=Prs|Strength=Strong
Pp2-----------s	Person=2|PronType=Prs|Strength=Strong
Pp2-sa--------s	Case=Acc|Number=Sing|Person=2|PronType=Prs|Strength=Strong
Pp2-sa--------w	Case=Acc|Number=Sing|Person=2|PronType=Prs|Strength=Weak
Pp2-sa--y-----w	Case=Acc|Number=Sing|Person=2|PronType=Prs|Strength=Weak|Variant=Short
Pp2-sd--------s	Case=Dat|Number=Sing|Person=2|PronType=Prs|Strength=Strong
Pp2-sd--------w	Case=Dat|Number=Sing|Person=2|PronType=Prs|Strength=Weak
Pp2-sd--y-----w	Case=Dat|Number=Sing|Person=2|PronType=Prs|Strength=Weak|Variant=Short
Pp2-sn--------s	Case=Nom|Number=Sing|Person=2|PronType=Prs|Strength=Strong
Pp2-so--------s	Case=Dat,Gen|Number=Sing|Person=2|PronType=Prs|Strength=Strong
Pp2-sr--------s	Case=Acc,Nom|Number=Sing|Person=2|PronType=Prs|Strength=Strong
Pp3fpa--------w	Case=Acc|Gender=Fem|Number=Plur|Person=3|PronType=Prs|Strength=Weak
Pp3fpa--y-----w	Case=Acc|Gender=Fem|Number=Plur|Person=3|PronType=Prs|Strength=Weak|Variant=Short
Pp3fpr--------s	Case=Acc,Nom|Gender=Fem|Number=Plur|Person=3|PronType=Prs|Strength=Strong
Pp3fsa--------w	Case=Acc|Gender=Fem|Number=Sing|Person=3|PronType=Prs|Strength=Weak
Pp3fsa--y-----w	Case=Acc|Gender=Fem|Number=Sing|Person=3|PronType=Prs|Strength=Weak|Variant=Short
Pp3fso--------s	Case=Dat,Gen|Gender=Fem|Number=Sing|Person=3|PronType=Prs|Strength=Strong
Pp3fsr--------s	Case=Acc,Nom|Gender=Fem|Number=Sing|Person=3|PronType=Prs|Strength=Strong
Pp3fsr--y-----s	Case=Acc,Nom|Gender=Fem|Number=Sing|Person=3|PronType=Prs|Strength=Strong|Variant=Short
Pp3fs---------s	Gender=Fem|Number=Sing|Person=3|PronType=Prs|Strength=Strong
Pp3mpa--------w	Case=Acc|Gender=Masc|Number=Plur|Person=3|PronType=Prs|Strength=Weak
Pp3mpa--y-----w	Case=Acc|Gender=Masc|Number=Plur|Person=3|PronType=Prs|Strength=Weak|Variant=Short
Pp3mpr--------s	Case=Acc,Nom|Gender=Masc|Number=Plur|Person=3|PronType=Prs|Strength=Strong
Pp3msa--------w	Case=Acc|Gender=Masc|Number=Sing|Person=3|PronType=Prs|Strength=Weak
Pp3msa--y-----w	Case=Acc|Gender=Masc|Number=Sing|Person=3|PronType=Prs|Strength=Weak|Variant=Short
Pp3mso--------s	Case=Dat,Gen|Gender=Masc|Number=Sing|Person=3|PronType=Prs|Strength=Strong
Pp3msr--------s	Case=Acc,Nom|Gender=Masc|Number=Sing|Person=3|PronType=Prs|Strength=Strong
Pp3msr--y-----s	Case=Acc,Nom|Gender=Masc|Number=Sing|Person=3|PronType=Prs|Strength=Strong|Variant=Short
Pp3ms---------s	Gender=Masc|Number=Sing|Person=3|PronType=Prs|Strength=Strong
Pp3-pd--------w	Case=Dat|Number=Plur|Person=3|PronType=Prs|Strength=Weak
Pp3-pd--y-----w	Case=Dat|Number=Plur|Person=3|PronType=Prs|Strength=Weak|Variant=Short
Pp3-po--------s	Case=Dat,Gen|Number=Plur|Person=3|PronType=Prs|Strength=Strong
Pp3-p---------s	Number=Plur|Person=3|PronType=Prs|Strength=Strong
Pp3-sd--------w	Case=Dat|Number=Sing|Person=3|PronType=Prs|Strength=Weak
Pp3-sd--y-----w	Case=Dat|Number=Sing|Person=3|PronType=Prs|Strength=Weak|Variant=Short
Pp3-so--------s	Case=Dat,Gen|Number=Sing|Person=3|PronType=Prs|Strength=Strong
Ps1fp-s	Gender=Fem|Number=Plur|Number[psor]=Sing|Person=1|Poss=Yes|PronType=Prs
Ps1fsrp	Case=Acc,Nom|Gender=Fem|Number=Sing|Number[psor]=Plur|Person=1|Poss=Yes|PronType=Prs
Ps1fsrs	Case=Acc,Nom|Gender=Fem|Number=Sing|Number[psor]=Sing|Person=1|Poss=Yes|PronType=Prs
Ps1mp-p	Gender=Masc|Number=Plur|Number[psor]=Plur|Person=1|Poss=Yes|PronType=Prs
Ps1ms-p	Gender=Masc|Number=Sing|Number[psor]=Plur|Person=1|Poss=Yes|PronType=Prs
Ps2fp-s	Gender=Fem|Number=Plur|Number[psor]=Sing|Person=2|Poss=Yes|PronType=Prs
Ps2fsrp	Case=Acc,Nom|Gender=Fem|Number=Sing|Number[psor]=Plur|Person=2|Poss=Yes|PronType=Prs
Ps2fsrs	Case=Acc,Nom|Gender=Fem|Number=Sing|Number[psor]=Sing|Person=2|Poss=Yes|PronType=Prs
Ps3fp-s	Gender=Fem|Number=Plur|Number[psor]=Sing|Person=3|Poss=Yes|PronType=Prs
Ps3fsrs	Case=Acc,Nom|Gender=Fem|Number=Sing|Number[psor]=Sing|Person=3|Poss=Yes|PronType=Prs
Ps3mp-s	Gender=Masc|Number=Plur|Number[psor]=Sing|Person=3|Poss=Yes|PronType=Prs
Ps3ms-s	Gender=Masc|Number=Sing|Number[psor]=Sing|Person=3|Poss=Yes|PronType=Prs
Ps3---p	Number[psor]=Plur|Person=3|Poss=Yes|PronType=Prs
Ps3---s	Number[psor]=Sing|Person=3|Poss=Yes|PronType=Prs
Pw3fpr	Case=Acc,Nom|Gender=Fem|Number=Plur|Person=3|PronType=Int,Rel
Pw3fso	Case=Dat,Gen|Gender=Fem|Number=Sing|Person=3|PronType=Int,Rel
Pw3mpr	Case=Acc,Nom|Gender=Masc|Number=Plur|Person=3|PronType=Int,Rel
Pw3mso	Case=Dat,Gen|Gender=Masc|Number=Sing|Person=3|PronType=Int,Rel
Pw3-po	Case=Dat,Gen|Number=Plur|Person=3|PronType=Int,Rel
Pw3--r	Case=Acc,Nom|Person=3|PronType=Int,Rel
Pw3-so	Case=Dat,Gen|Number=Sing|Person=3|PronType=Int,Rel
Px3--a--------s	Case=Acc|Person=3|PronType=Prs|Reflex=Yes|Strength=Strong
Px3--a--------w	Case=Acc|Person=3|PronType=Prs|Reflex=Yes|Strength=Weak
Px3--a--y-----w	Case=Acc|Person=3|PronType=Prs|Reflex=Yes|Strength=Weak|Variant=Short
Px3--d--------w	Case=Dat|Person=3|PronType=Prs|Reflex=Yes|Strength=Weak
Px3--d--y-----w	Case=Dat|Person=3|PronType=Prs|Reflex=Yes|Strength=Weak|Variant=Short
Pz3fsr	Case=Acc,Nom|Gender=Fem|Number=Sing|Person=3|PronType=Neg
Pz3-sr	Case=Acc,Nom|Number=Sing|Person=3|PronType=Neg
Qf	Tense=Fut
Qn	PartType=Inf
Qs	Mood=Sub
Qs-y	Mood=Sub|Variant=Short
Qz	Polarity=Neg
Qz-y	Polarity=Neg|Variant=Short
Rgp	Degree=Pos
Rgpy	Degree=Pos|Variant=Short
Rgs	Degree=Sup
Rw	PronType=Int,Rel
Rw-y	PronType=Int,Rel|Variant=Short
Rz	PronType=Neg
Sp	AdpType=Prep
Spsa	AdpType=Prep|Case=Acc
Spsay	AdpType=Prep|Case=Acc|Variant=Short
Spsd	AdpType=Prep|Case=Dat
Spsg	AdpType=Prep|Case=Gen
Tdfpr	Case=Acc,Nom|Gender=Fem|Number=Plur|PronType=Dem
Tdfso	Case=Dat,Gen|Gender=Fem|Number=Sing|PronType=Dem
Tdfsr	Case=Acc,Nom|Gender=Fem|Number=Sing|PronType=Dem
Tdmpr	Case=Acc,Nom|Gender=Masc|Number=Plur|PronType=Dem
Tdmso	Case=Dat,Gen|Gender=Masc|Number=Sing|PronType=Dem
Tdmsr	Case=Acc,Nom|Gender=Masc|Number=Sing|PronType=Dem
Td-po	Case=Dat,Gen|Number=Plur|PronType=Dem
Tffpoy	Case=Dat,Gen|Definite=Def|Gender=Fem|Number=Plur|PronType=Art|Variant=Short
Tffpry	Case=Acc,Nom|Definite=Def|Gender=Fem|Number=Plur|PronType=Art|Variant=Short
Tffs-y	Definite=Def|Gender=Fem|Number=Sing|PronType=Art|Variant=Short
Tfmpoy	Case=Dat,Gen|Definite=Def|Gender=Masc|Number=Plur|PronType=Art|Variant=Short
Tfmsoy	Case=Dat,Gen|Definite=Def|Gender=Masc|Number=Sing|PronType=Art|Variant=Short
Tfmsry	Case=Acc,Nom|Definite=Def|Gender=Masc|Number=Sing|PronType=Art|Variant=Short
Tfms-y	Definite=Def|Gender=Masc|Number=Sing|PronType=Art|Variant=Short
Tf-so	Case=Dat,Gen|Definite=Def|Number=Sing|PronType=Art
Tifp-y	Gender=Fem|Number=Plur|PronType=Ind|Variant=Short
Tifso	Case=Dat,Gen|Gender=Fem|Number=Sing|PronType=Ind
Tifsr	Case=Acc,Nom|Gender=Fem|Number=Sing|PronType=Ind
Timso	Case=Dat,Gen|Gender=Masc|Number=Sing|PronType=Ind
Timsr	Case=Acc,Nom|Gender=Masc|Number=Sing|PronType=Ind
Ti-po	Case=Dat,Gen|Number=Plur|PronType=Ind
Tsfp	Gender=Fem|Number=Plur|Poss=Yes|PronType=Prs
Tsfs	Gender=Fem|Number=Sing|Poss=Yes|PronType=Prs
Tsmp	Gender=Masc|Number=Plur|Poss=Yes|PronType=Prs
Tsms	Gender=Masc|Number=Sing|Poss=Yes|PronType=Prs
Va--1	Person=1
Va--1p	Number=Plur|Person=1
Va--1s	Number=Sing|Person=1
Va--1s----y	Number=Sing|Person=1|Variant=Short
Va--1-----y	Person=1|Variant=Short
Va--2p	Number=Plur|Person=2
Va--2p----y	Number=Plur|Person=2|Variant=Short
Va--2s	Number=Sing|Person=2
Va--2s----y	Number=Sing|Person=2|Variant=Short
Va--3	Person=3
Va--3p	Number=Plur|Person=3
Va--3p----y	Number=Plur|Person=3|Variant=Short
Va--3s	Number=Sing|Person=3
Va--3s----y	Number=Sing|Person=3|Variant=Short
Va--3-----y	Person=3|Variant=Short
Vag	VerbForm=Ger
Vag-------y	Variant=Short|VerbForm=Ger
Vaii1	Mood=Ind|Person=1|Tense=Imp|VerbForm=Fin
Vaii2s	Mood=Ind|Number=Sing|Person=2|Tense=Imp|VerbForm=Fin
Vaii3p	Mood=Ind|Number=Plur|Person=3|Tense=Imp|VerbForm=Fin
Vaii3s	Mood=Ind|Number=Sing|Person=3|Tense=Imp|VerbForm=Fin
Vail3p	Mood=Ind|Number=Plur|Person=3|Tense=Pqp|VerbForm=Fin
Vail3s	Mood=Ind|Number=Sing|Person=3|Tense=Pqp|VerbForm=Fin
Vaip1p	Mood=Ind|Number=Plur|Person=1|Tense=Pres|VerbForm=Fin
Vaip1s	Mood=Ind|Number=Sing|Person=1|Tense=Pres|VerbForm=Fin
Vaip2p	Mood=Ind|Number=Plur|Person=2|Tense=Pres|VerbForm=Fin
Vaip2s	Mood=Ind|Number=Sing|Person=2|Tense=Pres|VerbForm=Fin
Vaip3p	Mood=Ind|Number=Plur|Person=3|Tense=Pres|VerbForm=Fin
Vaip3p----y	Mood=Ind|Number=Plur|Person=3|Tense=Pres|Variant=Short|VerbForm=Fin
Vaip3s	Mood=Ind|Number=Sing|Person=3|Tense=Pres|VerbForm=Fin
Vaip3s----y	Mood=Ind|Number=Sing|Person=3|Tense=Pres|Variant=Short|VerbForm=Fin
Vais3p	Mood=Ind|Number=Plur|Person=3|Tense=Past|VerbForm=Fin
Vais3s	Mood=Ind|Number=Sing|Person=3|Tense=Past|VerbForm=Fin
Vam-2s	Mood=Imp|Number=Sing|Person=2|VerbForm=Fin
Vanp	Tense=Pres|VerbForm=Inf
Vap--sm	Gender=Masc|Number=Sing|VerbForm=Part
Vasp1p	Mood=Sub|Number=Plur|Person=1|Tense=Pres|VerbForm=Fin
Vasp1s	Mood=Sub|Number=Sing|Person=1|Tense=Pres|VerbForm=Fin
Vasp2p	Mood=Sub|Number=Plur|Person=2|Tense=Pres|VerbForm=Fin
Vasp2s	Mood=Sub|Number=Sing|Person=2|Tense=Pres|VerbForm=Fin
Vasp3	Mood=Sub|Person=3|Tense=Pres|VerbForm=Fin
Vmg	VerbForm=Ger
Vmg-------y	Variant=Short|VerbForm=Ger
Vmii1	Mood=Ind|Person=1|Tense=Imp|VerbForm=Fin
Vmii1-----y	Mood=Ind|Person=1|Tense=Imp|Variant=Short|VerbForm=Fin
Vmii2p	Mood=Ind|Number=Plur|Person=2|Tense=Imp|VerbForm=Fin
Vmii2s	Mood=Ind|Number=Sing|Person=2|Tense=Imp|VerbForm=Fin
Vmii3p	Mood=Ind|Number=Plur|Person=3|Tense=Imp|VerbForm=Fin
Vmii3p----y	Mood=Ind|Number=Plur|Person=3|Tense=Imp|Variant=Short|VerbForm=Fin
Vmii3s	Mood=Ind|Number=Sing|Person=3|Tense=Imp|VerbForm=Fin
Vmii3s----y	Mood=Ind|Number=Sing|Person=3|Tense=Imp|Variant=Short|VerbForm=Fin
Vmil1	Mood=Ind|Person=1|Tense=Pqp|VerbForm=Fin
Vmil1p	Mood=Ind|Number=Plur|Person=1|Tense=Pqp|VerbForm=Fin
Vmil2s	Mood=Ind|Number=Sing|Person=2|Tense=Pqp|VerbForm=Fin
Vmil3p	Mood=Ind|Number=Plur|Person=3|Tense=Pqp|VerbForm=Fin
Vmil3p----y	Mood=Ind|Number=Plur|Person=3|Tense=Pqp|Variant=Short|VerbForm=Fin
Vmil3s	Mood=Ind|Number=Sing|Person=3|Tense=Pqp|VerbForm=Fin
Vmil3s----y	Mood=Ind|Number=Sing|Person=3|Tense=Pqp|Variant=Short|VerbForm=Fin
Vmip1p	Mood=Ind|Number=Plur|Person=1|Tense=Pres|VerbForm=Fin
Vmip1p----y	Mood=Ind|Number=Plur|Person=1|Tense=Pres|Variant=Short|VerbForm=Fin
Vmip1s	Mood=Ind|Number=Sing|Person=1|Tense=Pres|VerbForm=Fin
Vmip1s----y	Mood=Ind|Number=Sing|Person=1|Tense=Pres|Variant=Short|VerbForm=Fin
Vmip2p	Mood=Ind|Number=Plur|Person=2|Tense=Pres|VerbForm=Fin
Vmip2s	Mood=Ind|Number=Sing|Person=2|Tense=Pres|VerbForm=Fin
Vmip2s----y	Mood=Ind|Number=Sing|Person=2|Tense=Pres|Variant=Short|VerbForm=Fin
Vmip3	Mood=Ind|Person=3|Tense=Pres|VerbForm=Fin
Vmip3p	Mood=Ind|Number=Plur|Person=3|Tense=Pres|VerbForm=Fin
Vmip3s	Mood=Ind|Number=Sing|Person=3|Tense=Pres|VerbForm=Fin
Vmip3s----y	Mood=Ind|Number=Sing|Person=3|Tense=Pres|Variant=Short|VerbForm=Fin
Vmip3-----y	Mood=Ind|Person=3|Tense=Pres|Variant=Short|VerbForm=Fin
Vmis1p	Mood=Ind|Number=Plur|Person=1|Tense=Past|VerbForm=Fin
Vmis1s	Mood=Ind|Number=Sing|Person=1|Tense=Past|VerbForm=Fin
Vmis3p	Mood=Ind|Number=Plur|Person=3|Tense=Past|VerbForm=Fin
Vmis3p----y	Mood=Ind|Number=Plur|Person=3|Tense=Past|Variant=Short|VerbForm=Fin
Vmis3s	Mood=Ind|Number=Sing|Person=3|Tense=Past|VerbForm=Fin
Vmis3s----y	Mood=Ind|Number=Sing|Person=3|Tense=Past|Variant=Short|VerbForm=Fin
Vmm-2p	Mood=Imp|Number=Plur|Person=2|VerbForm=Fin
Vmm-2s	Mood=Imp|Number=Sing|Person=2|VerbForm=Fin
Vmnp	Tense=Pres|VerbForm=Inf
Vmnp------y	Tense=Pres|Variant=Short|VerbForm=Inf
Vmp--pf	Gender=Fem|Number=Plur|VerbForm=Part
Vmp--pm	Gender=Masc|Number=Plur|VerbForm=Part
Vmp--sf	Gender=Fem|Number=Sing|VerbForm=Part
Vmp--sm	Gender=Masc|Number=Sing|VerbForm=Part
Vmp--sm---y	Gender=Masc|Number=Sing|Variant=Short|VerbForm=Part
Vmsp1p	Mood=Sub|Number=Plur|Person=1|Tense=Pres|VerbForm=Fin
Vmsp2p	Mood=Sub|Number=Plur|Person=2|Tense=Pres|VerbForm=Fin
Vmsp2s	Mood=Sub|Number=Sing|Person=2|Tense=Pres|VerbForm=Fin
Vmsp3	Mood=Sub|Person=3|Tense=Pres|VerbForm=Fin
Vmsp3-----y	Mood=Sub|Person=3|Tense=Pres|Variant=Short|VerbForm=Fin
X	Foreign=Yes
Y	Abbr=Yes
Ya	Abbr=Yes
Yn	Abbr=Yes
Ynfsoy	Abbr=Yes|Case=Dat,Gen|Definite=Def|Gender=Fem|Number=Sing
Ynfsry	Abbr=Yes|Case=Acc,Nom|Definite=Def|Gender=Fem|Number=Sing
Ynmsoy	Abbr=Yes|Case=Dat,Gen|Definite=Def|Gender=Masc|Number=Sing
Ynmsry	Abbr=Yes|Case=Acc,Nom|Definite=Def|Gender=Masc|Number=Sing
Yp	Abbr=Yes
Yp-p	Abbr=Yes|Number=Plur
Yp-sr	Abbr=Yes|Case=Acc,Nom|Number=Sing
Yr	Abbr=Yes
